11
111111110000000
111111110000000
111111110000000
111111110000000
111111111111111
111111111111111
001111111111111
001111111111111
001111111111111
001110001111111
001110001111111
001110001111111
001110001111111
000011111111111
000011111111111
000011111111111
000011111111111
000011111111111
000011100000111
000011100000111
11
00000000
00000000
00000001
00000000
000000000001110
010000000000000
0000000000000
0000000000000
0001110000000
0000000000
0000010000
0000000000
0000000000
11000000000
00000001110
00000000000
00000000000
00010000000
000000
000000
