11
111111111111111
111111111111111
111111111111111
111111111111111
111111111111111
111111111111111
111111111111111
111111111111111
111111111111111
111111111111111
111111111111111
111111111111111
111111111111111
111111111111111
111111111111111
111111111111111
111111111111111
111111111111111
111111111111111
111111111111111
11
000000000000000
000000000000000
000000000000000
000000000000000
000000000000000
000000000000000
000000010000000
000000000010000
000000000000000
000000001000000
000010000000000
000000000000000
000000000000100
000010000000000
000000010000000
000000000000000
000000000100000
000000100000000
000000000000000
000000000000000
